
                         *
                       * *
             **      **            **
            *   *    **            **
 **        *     *   **
 **        *   * **    * *
           *     *       *
            *   *
             **