


               ***    * *    *     *   ***
              *      *   *   * * * *   *
              *      * * *   *  *  *   **
              *  *   *   *   *     *   *
    **   ***   ***   *   *   *     *   ***
   *  *  **
    **   *       *       *     ***     ***
                 *       *     *       * 
                 *       *     **      ** 
                 *       *     *       * 
                 ***     *     *       ***