 
 
 
 
      *             *  *   *
       *     *     *   *  *
        *   * *   *    * *
         * *   * *     *  *
          *     *      *   *

     **************************

     *   *   * *   *  *  * * *  * * *
      * * * *  * * *  *    *    * * 
       *   *   *   *  *    *    * * *

     *  *  * * *  * * *  * * *  * * *  * * *  
     * *   * *    * *    * * *  * *    * * *   
     *  *  * * *  * * *  *      * * *  *  *    
   